немец->не+мец
тым->ты+м
часам->ча+сам
лязгнуў->ля+згнуў
затворам->затво+рам
штось->што+сь
крыкнуў->кры+кнуў
матляючы->матля+ючы
поламі->по+ламі
шынэля->шынэ+ля
пайшоў->пайшо+ў
дарозе->даро+зе
карабін->карабі+н
трымаў->трыма+ў
напагатове->напагато+ве
прыкладам->прыкла+дам
пад->па+д
пахай->па+хай
іваноўскі->івано+ўскі
патроху->патро+ху
адпускаў->адпуска+ў
сабой->сабо+й
планку->пла+нку
гранаты->грана+ты
моўчкі->мо+ўчкі
паўтараў->паўтара+ў
малітву->малі+тву
ідзі->ідзі+
ён->ё+н
чакаў->чака+ў
увесь->у+весь
ператварыўшыся->ператвары+ўшыся
жывое->жыво+е
ўвасабленне->ўвасабле+нне
чакання->чака+ння
іншае->і+ншае
ужо->ужо+
быў->бы+ў
здольны->здо+льны
мог->мо+г
дакінуць->дакі+нуць
немца->не+мца
гранату->грана+ту
толькі->то+лькі
ўзарваць->ўзарва+ць
яго->яго+
разам->ра+зам
сабой->сабо+й
аднак->адна+к
гэты->гэ+ты
абознік->або+знік
відаць->віда+ць
быў->бы+ў
надта->на+дта
каб->ка+б
смелы->сме+лы
ішоў->ішо+ў
яго->яго+
так->та+к
асцярожна->асцяро+жна
што->што+
здавалася->здава+лася
кожную->ко+жную
секунду->секу+нду
мог->мо+г
павярнуць->павярну+ць
назад->наза+д
ўсё->ўсё+
набліжаўся->набліжа+ўся
ўжо->ўжо+
бачыў->ба+чыў
няголены->няго+лены
нейкі->не+йкі
заспаны->за+спаны
ягоны->яго+ны
твар->тва+р
заінелыя->заіне+лыя
гузікі->гу+зікі
шынэлі->шынэ+лі
далёка->далё+ка
яшчэ->яшчэ+
дайшоўшы->дайшо+ўшы
лейтэнанта->лейтэна+нта
зноў->зно+ў
штось->што+сь
гукнуў->гукну+ў
спыніўся->спыні+ўся
наступнае->насту+пнае
імгненне->імгне+нне
лейтэнант->лейтэна+нт
ледзь->ле+дзь
закрычаў->закрыча+ў
крыўды->кры+ўды
убачыўшы->уба+чыўшы
немец->не+мец
узнімае->узніма+е
пляча->пляча+
карабін->карабі+н
пачынае->пачына+е
цэліцца->цэ+ліцца
цэліўся->цэ+ліўся
няўмела->няўме+ла
надта->на+дта
старанна->стара+нна
ствол->ство+л
карабіна->карабі+на
доўга->до+ўга
хадзіў->хадзі+ў
боку->бо+ку
бок->бо+к
напарнік->напа+рнік
яго->яго+
ўсё->ўсё+
гергетаў->гергета+ў
штось->што+сь
воза->во+за
напэўна->напэ+ўна
даваў->дава+ў
парады->пара+ды
па-ранейшаму->па-ране+йшаму
ляжаў->ляжа+ў
нерухома->нерухо+ма
шырока->шыро+ка
расплюшчанымі->расплю+шчанымі
вачыма->вачы+ма
глядзеў->глядзе+ў
свайго->свайго+
забойцу->забо+йцу
слёзы->слё+зы
роспачы->ро+спачы
каціліся->каці+ліся
твары->тва+ры
вось->во+сь
дачакаўся->дачака+ўся
світання->світа+ння
сустрэў->сустрэ+ў
дарозе->даро+зе
немцаў->не+мцаў
усё->усё+
канчалася->канча+лася
недарэчна->недарэ+чна
подла->по+дла
бяздарна->бязда+рна
якім->які+м
выпадку->выпа+дку
павінна->паві+нна
было->было+
канчацца->канча+цца
яму->яму+
цяпер->цяпе+р
заставалася->застава+лася
устаць->уста+ць
крыкнуць->кры+кнуць
падняць->падня+ць
угору->уго+ру
рукі->ру+кі
або->або+
ціха->ці+ха
пакорна->пако+рна
прыняць->прыня+ць
гэту->гэ+ту
апошнюю->апо+шнюю
кулю->ку+лю
ўпор->ўпо+р
каб->ка+б
назаўсёды->назаўсё+ды
знікнуць->зні+кнуць
твару->тва+ру
зямлі->зямлі+
вядома->вядо+ма
знікне->зні+кне
цяпер->цяпе+р
яму->яму+
засталося->застало+ся
некалькі->не+калькі
лічаных->лі+чаных
секунд->секу+нд
якімі->які+мі
настане->наста+не
вечны->ве+чны
вялікі->вялі+кі
спакой->спако+й
ягоным->яго+ным
становішчы->стано+вішчы
гэта->гэ+та
было->было+
нават->на+ват
зманліва->зма+нліва
адразу->адра+зу
вызваляла->вызваля+ла
пакут->паку+т
але->але+
застануцца->застану+цца
жыць->жы+ць
іншыя->і+ншыя
яны->яны+
перамогуць->перамо+гуць
ім->і+м
аднаўляць->аднаўля+ць
гэту->гэ+ту
зялёную->зялё+ную
шчаслівую->шчаслі+вую
зямлю->зямлю+
дыхаць->ды+хаць
поўныя->по+ўныя
грудзі->гру+дзі
кахаць->каха+ць
хто->хто+
ведае->ве+дае
залежыць->зале+жыць
шчаслівы->шчаслі+вы
лёс->лё+с
таго->таго+
памрэ->памрэ+
гэтай->гэ+тай
дарозе->даро+зе
дваццацідвухгадовы->дваццацідвухгадо+вы
камандзір->камандзі+р
узвода->узво+да
лейтэнант->лейтэна+нт
